<SN>	<SN/>
<UNKNOWN>	<UNKNOWN/>
<comma >	<comma>
<FILL/ >	<FILL/>
<FILL />	<FILL/>
<FILL>	<FILL/>
<CNOISE>	<CNOISE/>
<comma/>	<comma>
<fullstop/>	<fullstop>
<questionmark/>	<questionmark>
<unknown>	<UNKNOWN/>
<question_mark/>	<questionmark>
<fill/>	<FILL/>
<cnoise>	<CNOISE/>
<CHOISE/>	<CNOISE/>
<exclamation_mark/>	<fullstop>
<questoinmark>	<questionmark>
<NOISE/>	<CNOISE/>
<ullstop>	<fullstop>
<UNKOWN/>	<UNKNOWN/>
</OVERLAP>	<OVERLAP/>
<OVERSLAP/>	<OVERLAP/>